####################
#||||x|||||||||||||#
#..................#
#..................#
#..................#
#..................#
####################
####################
####################
@
player 3 4
