############################
#x|0||000||0|0||00||0||000|#
#..........................#
#..........................#
############################
@
player 2 3
lost_soul 13 2 