####################################
#||||||||||||x|||||||||||||||||||||#
#..................................#
#..................................#
#..................................#
#..................................#
########################..........#.
#||||||||||||||||||||||||..........#
#..................................#
#..................................#
####################################
@
player 5 8
vent 10 8 28 3 