####################
#....x.............#
#..................#
#..................#
#..................#
#..@...............#
####################
####################
####################
---

