############################
#x.........................#
#..........................#
#..........................#
############################
---
lost_soul 13 2 