##################################
#................................#
#................................#
#.@..............................#
#................................#
#................................#
#................................#
##################################
#.......................x........#
#................................#
##################################
---
locked_door 15 1 15 8 25 5
lost_soul 20 4
cockroach 10 3 22 3 