####################################
#............x.....................#
#..................................#
#..................................#
#..................................#
#..................................#
########################...........#
#..................................#
#....@.............................#
#..................................#
####################################
---
vent 10 8 28 3 