####################################
#..................................#
#.@................................#
#..........##########..............#
#..................................#
#..................................#
#................................###
#.................................x#
####################################
---
vent 5 2 30 6
vent 10 5 25 1
lost_soul 18 5
cockroach 14 2 14 6 