################################
#.......x......................#
#..............................#
#..............................#
#.@............................#
#..............................#
#..............................#
################################
#..............................#
#..............................#
################################
---
cockroach 2 2 29 2
cockroach 29 3 2 3
cockroach 2 5 29 5
cockroach 29 6 2 6 