..........
.@........
..........
..........
########..
.x.....#..
.......#..
.......#..
..........
..........
---